1111111111111
100100P000C01
10C0011111101
100011C0E00C1
1111111111111