1111111111111
1001000000C01
10C0011111101
100011CP0E0C1
1111111111111

